
Animalia=�llatok
Chordata=Gerinch�rosok
Vertebrata=Gerincesek

Aves=Madarak
Aves.d=A madarak tollal rendelkez� �llatok.

Passeriformes=Verébalkatúak
Passeriformes.d=Ezek az �nekesmadarak.
Sylvidae=Posz�taf�l�k
Fringillidae=Pintyf�l�k
Corvidae=Varj�f�l�k
Hirundidae=Fecskef�l�k
Turdidae=Rig�f�l�k
Motacillidae=Billeget�f�l�k
Muscicapidae=L�gykap�f�l�k
Paridae=Cinegef�l�k
Sturnidae=Sereg�lyf�l�k
Passeridae=Ver�bf�l�k
Passeridae.d=ezek a verebek.

Anseriformes=L�dalkat�ak
Anatidae=R�cef�l�k

Ciconiiformes=G�lyaalak�ak
Ciconidae=G�lyaf�l�k

Columbiformes=Galambalak�ak
Columbidae=Galambf�l�k

Piciformes=Hark�lyalak�ak
Picidae=Hark�lyf�l�k

Falconiformes=S�lyomalak�ak
Falconidae=S�lyomf�l�k

Gruiformes=Darualak�ak
Rallidae=Guvatf�l�k

Charadriiformes=Lilealak�ak
Laridae=Sir�lyf�l�k

Pelecanformes=G�d�nyalak�ak
Phalacrocoracidae=K�r�katonaf�l�k

